{
  "nivel": 1,
  "potenciadores": 2,
  "bloques": [
		"0 0 0 0 0 0 0 0 0 0 0",
		"0 0 0 0 0 0 0 0 0 0 0",
		"0 0 0 0 2 2 2 0 0 0 0",
		"0 0 0 2 1 1 1 2 0 0 0",
		"0 0 2 1 1 4 1 1 2 0 0",
		"0 2 1 1 1 1 1 1 1 2 0",
		"0 2 2 2 2 2 2 2 2 2 0",
		"0 3 4 5 1 1 1 5 4 3 0"
	]
}
