{
  "nivel": 2,
  "potenciadores": 12,
  "bloques": [
		"1 0 0 0 0 0 0 0 0 0 0",
		"3 1 0 0 0 0 0 0 0 0 0",
		"3 2 1 0 0 0 0 0 0 0 0",
		"3 2 1 1 0 0 0 0 0 0 0",
		"3 2 1 1 1 0 0 0 0 0 0",
		"3 2 1 1 2 1 0 0 0 0 0",
		"3 2 1 2 1 1 1 0 0 0 0",
		"3 2 1 1 1 4 1 1 0 0 0",
		"3 2 1 1 1 1 1 1 1 0 0",
		"3 2 2 2 2 2 2 2 2 2 0",
		"4 4 4 4 4 4 4 4 4 4 1"
	]
}
