{
  "nivel": 9,
  "potenciadores": 15,
  "bloques": [
    "1 0 2 0 3 0 4 0 5 0 6",
    "0 1 0 2 0 3 0 4 0 5 0",
    "6 0 1 0 2 0 3 0 4 0 5",
    "0 6 0 1 0 2 0 3 0 4 0",
    "5 0 6 0 1 0 2 0 3 0 4",
    "0 5 0 6 0 1 0 2 0 3 0",
    "4 0 5 0 6 0 1 0 2 0 3",
    "0 4 0 5 0 6 0 1 0 2 0",
    "3 0 4 0 5 0 6 0 1 0 2",
    "0 3 0 4 0 5 0 6 0 1 0",
    "2 0 3 0 4 0 5 0 6 0 1"
  ]
}